0000000000000000
0000000000000001
0000000000000011
0000000000111111
0000000000111111
0000000000111111
0000000011111111
0000000011111111
0000000011111110
0000000011111110
0000000011111110
0000000011111110
0000000111111110
0000000111111110
0000000111111110
0000001111111110
0000001111111110
0000011111111110
0000011111111110
0000011111111110
0000111111111100
0001111111111100
0001111111111100
0011111111111100
0111111111111100
0111111111111100
0111111111111100
0111111111111100
0011111111111000
0011111111111000
0011111111111000
0001111111110000
0001111111110000
0001111111110000
0000111111100000
0000111111100000
0000111111100000
0000011111100000
0000011111100000
0000011111100000
0000001111000000
0000001111000000
0000001111000000
0000000110000000
0000000110000000
0000000110000000
0000000110000000
0000000000000000
